.................
..@@@............
.................
.................
...2...G.GGG.....
.......G.........
.................
.................
..O..............
......22.........
.................
.................
......2.......X..
......2..........
.................
